return {
title = "jinglebells",
lines = { 
{ 391, 271, 383, 271, 377, 271, 371, 271, 363, 271, 357, 271, 351, 271, 345, 272, 339, 274, 333, 276, 326, 279, 322, 283, 318, 287, 314, 291, 311, 296, 310, 301, 310, 307, 310, 313, 310, 319, 313, 325, 316, 330, 320, 334, 325, 337, 330, 340, 336, 342, 342, 346, 348, 346, 354, 346, 360, 346, 368, 346, 373, 345, 378, 343, 383, 340, 388, 338, 392, 334, 396, 329, 400, 323, 404, 319, 407, 314, 407, 308, 407, 302, 407, 296, 407, 290, 407, 284, 405, 277, 398, 274, 393, 271, 387, 271,  },
{ 632, 265, 625, 265, 615, 266, 609, 266, 601, 270, 596, 273, 592, 277, 589, 282, 585, 288, 582, 293, 580, 301, 578, 307, 578, 313, 578, 319, 578, 325, 579, 330, 581, 335, 584, 340, 590, 344, 596, 346, 602, 348, 608, 350, 614, 352, 620, 352, 627, 353, 632, 354, 640, 354, 646, 354, 651, 352, 657, 348, 663, 344, 668, 339, 673, 334, 676, 327, 677, 320, 677, 312, 677, 304, 676, 296, 673, 289, 670, 284, 667, 279, 662, 276, 656, 272, 651, 269, 645, 265, 639, 261, 631, 259, 625, 257, 619, 257, 613, 257, 607, 258, 603, 262,  },
{ 220, 424, 209, 420, 201, 418, 195, 418, 187, 418, 179, 418, 170, 418, 162, 420, 154, 422, 149, 423, 144, 426, 138, 428, 132, 432, 126, 435, 120, 440, 113, 447, 107, 455, 104, 460, 101, 465, 99, 471, 99, 477, 99, 483, 100, 489, 104, 495, 107, 500, 111, 504, 116, 507, 120, 511, 126, 515, 131, 516, 137, 518, 144, 519, 149, 520, 155, 520, 163, 520, 169, 520, 175, 520, 183, 520, 191, 520, 196, 518, 201, 514, 207, 509, 212, 506, 219, 501, 223, 497, 228, 492, 231, 487, 234, 482, 237, 475, 238, 470, 240, 462, 240, 456, 240, 448, 240, 442, 240, 434, 238, 429, 234, 425, 226, 421, 221, 420, 216, 419, 210, 419,  },
{ 554, 451, 544, 447, 536, 447, 518, 447, 501, 447, 478, 447, 459, 451, 444, 458, 433, 463, 426, 468, 421, 473, 415, 478, 411, 482, 407, 488, 404, 494, 404, 502, 404, 510, 404, 516, 405, 522, 407, 528, 411, 536, 415, 542, 420, 549, 428, 555, 438, 559, 443, 562, 453, 566, 461, 570, 466, 571, 471, 572, 477, 574, 485, 576, 491, 578, 501, 578, 507, 578, 513, 578, 519, 578, 525, 578, 531, 578, 539, 577, 545, 573, 552, 570, 558, 564, 562, 560, 567, 555, 573, 549, 578, 542, 580, 532, 582, 527, 582, 517, 582, 507, 582, 497, 581, 491, 577, 483, 573, 477, 571, 471, 566, 466, 562, 462, 555, 459, 550, 458, 545, 455, 540, 452, 535, 449, 530, 446, 524, 446,  },
{ 864, 448, 858, 446, 853, 445, 848, 444, 840, 444, 832, 442, 816, 442, 799, 442, 785, 442, 771, 442, 761, 444, 755, 445, 750, 449, 746, 453, 741, 456, 733, 462, 726, 469, 719, 476, 715, 480, 712, 485, 707, 492, 705, 498, 703, 506, 703, 514, 703, 520, 703, 526, 703, 536, 706, 544, 710, 551, 713, 557, 719, 565, 725, 569, 729, 573, 733, 577, 740, 581, 746, 584, 753, 587, 759, 590, 769, 592, 775, 594, 781, 594, 787, 594, 797, 594, 803, 594, 813, 594, 819, 593, 828, 588, 833, 583, 837, 579, 841, 575, 848, 568, 852, 563, 858, 555, 861, 550, 863, 544, 866, 537, 868, 529, 868, 523, 870, 515, 870, 507, 870, 499, 869, 491, 868, 486, 867, 479, 865, 473, 863, 467, 863, 459, 861, 451, 858, 446, 852, 442, 844, 440, 836, 440, 830, 440, 824, 440,  },
{ 508, 148, 508, 155, 507, 161,  },
{ 213, 773, 213, 780, 213, 786, 213, 794, 213, 800, 213, 808, 213, 814, 213, 822, 213, 830, 213, 838, 212, 843, 211, 848, 211, 854, 211, 860, 209, 866, 209, 874, 209, 882, 209, 890, 209, 896, 209, 902, 209, 910, 209, 918, 209, 924, 209, 930, 209, 936, 209, 944, 209, 954, 209, 962, 210, 972, 212, 980, 212, 988, 214, 994, 214, 1002, 215, 1007, 216, 1014, 216, 1020, 216, 1030, 218, 1038, 218, 1046, 220, 1054, 222, 1062, 224, 1067, 226, 1073, 228, 1079, 231, 1086, 232, 1091, 234, 1097, 236, 1103, 238, 1109, 242, 1117, 246, 1125, 249, 1130, 252, 1135, 257, 1140, 261, 1144, 265, 1150, 269, 1154, 273, 1158, 279, 1162, 285, 1166, 293, 1168, 300, 1171, 305, 1173, 311, 1174, 317, 1174, 323, 1176, 330, 1177, 335, 1178, 341, 1178, 347, 1178, 353, 1178, 360, 1177, 365, 1175, 372, 1174, 379, 1171, 385, 1169, 390, 1166, 395, 1163, 402, 1160, 407, 1157, 413, 1153, 417, 1149, 422, 1144, 427, 1137, 432, 1130, 436, 1124, 439, 1119, 443, 1111, 446, 1106, 449, 1100, 452, 1094, 456, 1088, 458, 1082, 458, 1076, 461, 1069, 462, 1064, 463, 1059, 464, 1054, 464, 1048, 464, 1042, 466, 1036, 467, 1031, 468, 1026, 468, 1020, 468, 1014, 468, 1008,  },
{ 782.88, 759.48, 782.88, 766.68, 782.88, 772.44, 782.88, 778.2, 781.44, 783.96, 781.44, 789.72, 781.44, 795.48, 781.44, 801.24, 781.44, 809.88, 781.44, 815.64, 781.44, 821.4, 781.44, 827.16, 778.56, 832.92, 778.56, 838.68, 778.56, 844.44, 778.56, 850.2, 775.68, 855.96, 772.8, 861.72, 772.8, 867.48, 769.92, 873.24, 768.48, 883.32, 767.04, 890.52, 767.04, 896.28, 767.04, 902.04, 767.04, 907.8, 764.16, 913.56, 764.16, 919.32, 762.72, 926.52, 761.28, 936.6, 761.28, 942.36, 758.4, 948.12, 756.96, 955.32, 755.52, 965.4, 755.52, 971.16, 752.64, 976.92, 752.64, 982.68, 749.76, 991.32, 749.76, 997.08, 746.88, 1002.84, 745.44, 1010.04, 744, 1017.24, 739.68, 1024.44, 738.24, 1031.64, 735.36, 1040.28, 732.48, 1046.04, 732.48, 1051.8, 729.6, 1057.56, 726.72, 1063.32, 726.72, 1069.08, 723.84, 1074.84, 720.96, 1080.6, 718.08, 1086.36, 713.76, 1093.56, 709.44, 1097.88, 703.68, 1103.64, 697.92, 1109.4, 692.16, 1112.28, 687.84, 1116.6, 682.08, 1119.48, 676.32, 1122.36, 670.56, 1125.24, 664.8, 1128.12, 659.04, 1128.12, 653.28, 1131, 647.52, 1133.88, 641.76, 1133.88, 636, 1136.76, 630.24, 1136.76, 624.48, 1136.76, 618.72, 1136.76, 611.52, 1138.2, 604.32, 1139.64, 598.56, 1139.64, 592.8, 1139.64, 587.04, 1138.2, 581.28, 1135.32, 574.08, 1133.88, 568.32, 1131, 559.68, 1128.12, 555.36, 1125.24, 549.6, 1123.8, 543.84, 1120.92, 538.08, 1116.6, 535.2, 1112.28, 528, 1107.96, 522.24, 1105.08, 517.92, 1100.76, 512.16, 1095, 507.84, 1090.68, 503.52, 1086.36, 499.2, 1079.16, 496.32, 1073.4, 490.56, 1067.64, 487.68, 1061.88, 484.8, 1056.12, 481.92, 1050.36, 479.04, 1044.6, 477.6, 1037.4, 474.72, 1031.64, 473.28, 1021.56, 470.4, 1015.8, 467.52, 1010.04, 467.52, 1004.28,  },
},
objects = { {type = 2, x = 1158, y = 479, w = 32, h = 32},  {type = 2, x = 459, y = 904, w = 32, h = 32},  {type = 1, x = 195.36, y = 742.2, w = 32, h = 32},  {type = 1, x = 765.6, y = 730.68, w = 32, h = 32}, }
}