return {
title = "quantenteleport",
lines = { 
{ 412, 39, 413, 50, 414, 55, 416, 60, 418, 71, 419, 78, 421, 84, 422, 92, 424, 97, 426, 102, 430, 110, 438, 121, 445, 126, 450, 129, 457, 132, 469, 138, 475, 140,  },
{ 518, 141, 528, 141, 541, 139, 552, 138, 561, 136, 569, 134, 574, 132, 579, 130, 586, 125, 591, 121, 593, 116, 594, 111, 597, 104, 599, 96, 599, 87, 599, 79, 599, 73, 598, 68, 598, 62, 597, 56, 597, 49, 596, 44,  },
{ 634, 161, 619, 169, 593, 180, 561, 194, 532, 212, 514, 222, 501, 227, 488, 231, 469, 238, 446, 247, 427, 255, 418, 259, 411, 262, 405, 264, 399, 267, 394, 269,  },
{ 425, 314, 409, 322, 382, 333, 340, 349, 295, 368, 269, 377, 242, 387, 232, 391, 226, 393, 221, 394,  },
{ 205, 313, 199, 313, 192, 315, 185, 318, 175, 321, 167, 325, 157, 330, 146, 335, 132, 342, 106, 352, 89, 358, 82, 360, 77, 361, 84, 370, 95, 380, 105, 390, 111, 397, 116, 400, 123, 405, 130, 410, 135, 416, 142, 423, 150, 429, 160, 435, 166, 437, 173, 440, 178, 441, 174, 448, 169, 455, 164, 463, 160, 468, 170, 473, 193, 479, 223, 489, 243, 497, 266, 506, 282, 512, 291, 516, 300, 518, 309, 519, 318, 521, 325, 522, 332, 523, 337, 524, 343, 530, 350, 536, 356, 541, 362, 545, 370, 547, 384, 548, 426, 548, 468, 549, 499, 553, 512, 554, 524, 557, 535, 559, 541, 559,  },
},
objects = { {type = 1, x = 330, y = 210, w = 32, h = 32},  {type = 1, x = 309, y = 494, w = 32, h = 32},  {type = 1, x = 267, y = 341, w = 32, h = 32},  {type = 2, x = 505, y = 512, w = 32, h = 32}, }
}